16 16
################
#...#..........#
#.....#####....#
#........#..##.#
####.....##....#
#...####.#..#..#
#...#.##.......#
#......#######.#
#.#..........#.#
######.........#
##.............#
#..#.#########.#
#..#.......###.#
#..#.......###D#
##......#..#####
################
2 2
21
3 7 0 1
3 6 1 1
5 8 0 -1
6 11 1 -1
7 14 0 -1
3 11 0 1
6 12 2 1
6 13 1 -1
2 12 2 -1
8 14 3 1
9 14 4 1
10 14 2 1
8 6 3 -1
7 6 1 1
7 5 1 -1
6 2 1 1
6 3 1 -1
7 2 1 -1
12 8 4 -1
13 8 2 -1
12 6 4 1
