16 16
################
##..#..#.......#
#......#......##
#...#..##..#..##
##.#...#......##
#......#.......#
#.........##...#
######.#.#..####
#....#.........#
#....#.#.......#
#....#.#..##...#
#....#.#..#D..##
#.#..#.#....#..#
#......#......##
#......#...#.###
################
4 4
49
4 2 0 1
2 4 1 1
2 5 0 -1
2 2 2 1
2 6 3 -1
5 2 1 -1
6 2 3 1
12 11 2 -1
11 12 2 -1
13 12 3 2
9 6 4 -10
6 6 5 -1
6 8 5 -1
8 8 5 1
8 6 5 1
10 6 5 -1
11 6 5 5
12 6 5 -2
13 6 5 -1
12 13 4 -2
4 8 4 1
2 10 4 4
2 11 4 -2
2 12 4 -4
5 13 4 4
4 12 4 -3
4 11 4 1
3 10 4 6
4 10 4 -5
5 10 4 1
5 11 4 1
5 12 4 3
3 12 4 3
13 3 3 -1
14 6 1 1
14 2 1 -1
14 1 0 -1
9 2 0 2
9 1 1 -2
9 3 1 -2
9 4 1 -2
10 2 0 -1
11 2 1 4
8 2 5 2
8 1 1 -2
11 3 5 -2
13 4 4 2
12 10 1 -1
10 12 1 -1
