8 16
################
#..#...D###...##
#.....#####....#
#..........#...#
#.....###...#..#
#.....#...#....#
#..#..#........#
################
1 1
16
2 2 0 1
2 3 0 2
2 4 0 3
3 3 1 1
4 3 1 2
5 3 1 3
3 7 1 -4
3 6 0 -4
3 8 0 -2
3 9 1 -2
1 6 2 1
5 8 2 -1
6 9 3 1
2 12 3 -2
3 14 3 1
4 13 3 1
