16 16
################
#..####........#
#...##.....#...#
#......##.#....#
#..###.##..#...#
#.#....###..#..#
#.#.##.##..##..#
#.#.....#......#
#.##....#..###.#
#....##.#..#...#
#....#.###.....#
#.##...##...##.#
#....#.##......#
#....#..######.#
#.......#D.....#
################
1 1
16
3 3 0 1
2 3 1 1
2 2 2 1
3 2 3 1
2 6 2 -1
13 2 0 -1
8 6 1 1
8 5 0 1
8 7 0 1
7 11 3 1
7 12 4 1
7 13 3 -1
7 10 4 -1
12 9 3 1
13 14 4 1
3 13 3 -2
