4 12
############
#..........#
######...#D#
############
1 1
4
1 3 0 1
1 5 1 1
1 6 1 -1
1 7 0 -2
