16 16
################
#............###
#............###
#..#...........#
#..####.###....#
#..#..###..#...#
#..#...#...#...#
#..#.......#...#
#..#.#...#.#...#
#..#..#.#..#...#
#..#.......#...#
#..#.#####.#...#
#..#.........#.#
#..#########.#.#
#............#D#
################
7 7
29
6 10 0 -1
8 10 1 -1
8 4 0 -1
10 8 0 1
10 6 1 1
6 4 1 -1
13 14 2 5
12 14 3 -3
3 13 3 3
3 14 2 -5
2 4 3 2
2 5 3 -1
2 6 3 2
3 7 3 1
2 8 3 2
2 9 3 1
2 11 2 2
2 10 2 3
4 2 2 -6
12 2 2 1
10 2 2 -1
3 5 3 1
3 6 3 -1
2 7 3 -1
3 8 3 -1
3 9 3 -4
6 2 4 1
8 2 4 -1
2 3 3 -1
