16 16
################
###...#..#.....#
##....#..#.....#
#.....#..#.....#
#.....#.#.#.#.##
#.........#....#
#####.....#....#
#.........#.#..#
#...#.......#..#
####......#.####
#...####.#.....#
#..............#
#...#........#.#
#...#.#####..#.#
#...#........#D#
################
2 2
24
3 2 0 1
4 2 0 -1
2 3 1 -1
2 4 1 1
13 14 1 5
12 14 0 5
5 5 0 -2
4 7 0 1
7 4 1 1
7 2 0 -3
2 7 1 -3
7 7 2 3
10 8 2 -1
8 10 2 -1
13 12 0 -5
14 12 1 -5
7 11 2 -1
2 11 0 -2
11 4 2 1
12 2 1 -2
7 13 0 -2
6 12 3 -1
5 12 3 1
4 13 3 1
