16 16
################
#.#............#
#.##.####.###..#
#..............#
#.#.#.#.#.#.##.#
#.#.#...#.#.#..#
#.#.#.#.#.#.#..#
#.#.......#.#..#
#...#.#####....#
#.###........#.#
#.....#.###.##.#
#.###..........#
#...##.###.###.#
#.#............#
#.............D#
################
1 1
18
8 13 0 -1
8 14 1 -1
11 13 1 1
11 14 0 -1
3 13 1 1
3 14 0 -1
1 12 2 -1
1 9 0 -1
13 6 1 1
14 6 0 -1
13 10 0 -1
14 10 1 -1
13 1 0 -1
14 1 1 -1
12 2 2 -1
9 10 0 1
9 5 2 1
8 11 0 1
