16 16
################
#......#.......#
#....#....#..#.#
#....#....#....#
#....#....####.#
#....#####.....#
#####....#..####
#........#....##
#.....#..#..#..#
#...#..#.#..#..#
#..#..#..#..#..#
#...#..#.#..#..#
#..#..#.##..#..#
#......#.#..#..#
#D.............#
################
1 1
35
2 2 0 -1
3 2 1 -1
4 2 0 1
3 3 0 1
2 3 1 -1
4 3 1 1
1 5 0 -2
1 4 1 2
1 9 2 2
3 7 2 -2
2 8 3 1
2 7 0 1
4 7 4 1
3 8 1 1
4 14 0 -1
2 12 0 1
1 12 1 -1
1 11 3 -1
10 11 4 1
9 11 0 1
8 11 4 1
7 11 0 1
6 11 2 1
11 11 0 1
12 11 2 1
14 10 0 1
14 11 0 -1
14 8 2 -1
14 7 2 1
14 2 2 -2
13 1 2 -2
7 7 2 1
7 5 0 1
8 5 5 1
9 5 1 1
