16 16
################
#..........#...#
####.......#...#
##.........#...#
##.##......#.###
#...#.#........#
#.......#.....##
#...#.#..#.##.##
#####..#.#.#...#
##.....#.......#
#........#.#...#
###.#......#.###
#...#.........##
#...#.......####
#...#.........D#
################
1 1
17
14 12 0 -8
2 13 0 2
13 2 0 2
11 3 1 1
12 3 2 1
4 12 2 -1
3 12 3 -1
10 2 0 -1
10 13 3 1
9 11 3 -1
9 13 0 2
6 2 0 2
5 13 0 -1
6 4 3 1
8 13 3 1
4 2 1 -1
1 3 0 8
