16 16
################
#D...#...#.....#
##.....#.#.....#
#....#......#.##
#........#.....#
##.#.#...##...##
#.........######
#.#....#.......#
#..............#
###.##....##.###
#....##..##...##
#.##..#..#.....#
#..#.....#..#.##
#..##.#..#.....#
#.....#..#.....#
################
3 3
17
5 2 0 1
5 4 1 1
4 5 2 1
2 5 3 1
1 2 2 3
4 6 2 -1
2 6 3 -1
6 4 1 -1
6 2 0 -1
9 3 0 -1
12 6 0 1
12 5 2 -1
13 2 2 -1
9 12 1 1
3 9 3 -1
3 10 2 -1
10 12 2 -1
