10 17
#################
##.........######
#.#####.##.######
#........#....###
#........#.##.###
#.#......#.##.###
#.#...........###
#.#.######.######
##.............D#
#################
2 1
15
3 3 0 2
4 3 0 1
5 3 0 -1
6 3 0 2
3 5 1 2
4 5 1 1
5 5 1 -1
6 5 1 2
3 7 2 2
4 7 2 1
5 7 2 -1
6 7 2 2
8 12 0 -3
8 13 1 -3
8 14 2 -3
