16 16
################
#...#..........#
#...#.......#..#
#............#.#
#...#..##..#...#
####..........##
#...#..##..#####
#...#.......#..#
#...#..##...#..#
#..#..#.....#..#
#..............#
###....###...###
#.....#...#....#
#...#.....#..###
#...#.....#...D#
################
14 1
24
12 2 0 1
13 3 0 1
10 3 0 -2
12 5 0 -2
13 6 1 1
13 8 0 1
13 7 2 1
14 6 2 1
9 2 1 1
9 1 2 1
8 2 0 1
7 2 2 1
4 13 0 1
3 12 3 1
2 11 1 1
14 13 1 -5
3 2 1 1
2 2 3 1
5 8 1 -1
5 7 1 1
7 7 3 -3
7 8 3 1
10 12 2 -1
9 13 1 1
