29 28
############################
#D.#.#......#....##...#..###
#................#..#....###
##.#.#.#....#......#...#...#
#.......#...###.##...##..#.#
##.#.#......###........#...#
#...........##....#........#
#....#......####..#......#.#
#...##.#####################
#...#..#..#....#...#.......#
#...#..#....##.#...#.###.#.#
#...#.....##....#..#...#...#
#...#...#..#.#.....#.#.#.#.#
#...#####.#.....#..#.......#
#...#........#.#...#.#.#.#.#
#...#...#..........#...#...#
#...################.#...#.#
#...#........#.....#.......#
#...#..#..#....#.#.#.#.#.#.#
#...#...#.........##...#.#.#
#...#....#.#.#..#..#...#...#
#...#.........#...##.......#
#...#.......#...#..#..#.#..#
#...#.....#........#.......#
#...##.##################.##
#..........................#
#..........................#
#..........................#
############################
4 4
62
3 4 0 8
5 4 1 8
4 3 2 8
4 5 3 8
2 12 0 -8
8 6 3 -8
24 6 1 -8
24 25 2 -8
20 10 1 -4
2 1 4 -3
19 15 1 8
17 8 1 -8
13 23 4 1
13 22 0 1
13 24 0 1
13 20 2 1
13 26 3 1
12 20 0 -1
11 20 2 1
10 20 0 -1
9 20 2 1
12 26 0 -1
11 26 2 1
10 26 0 -1
9 26 2 1
20 25 2 -1
22 25 0 1
21 25 2 -1
22 21 2 -1
2 14 1 1
2 15 1 -1
4 15 1 -1
5 15 5 1
6 16 2 1
2 22 4 1
2 23 0 -4
3 18 0 1
6 20 0 1
5 21 0 1
4 26 0 1
10 6 5 1
11 6 5 -1
11 7 5 1
22 17 1 -4
14 6 4 1
14 8 2 -1
11 9 3 1
13 17 3 -1
12 17 3 1
11 17 3 -1
10 17 3 3
14 17 3 3
13 13 0 -5
11 13 0 -5
12 14 0 16
9 12 0 5
22 6 3 -1
21 6 3 1
18 16 4 1
21 13 3 -1
21 12 5 -1
1 2 4 -3
